di|display|around
_re|_readIndex|around
pa|parent|around
const|constructor|around
i|index|file
noti|notifications|around
init|initShaderProgram|around
shader|shaderProgram|around
shad|shaderProgram|around
sha|shaderProgram|around
fra|fragmentShader|around
att|attachShader|around
ver|vertexShader|around
os|osc_frag.glsl|file
osc_|osc_vert.glsl|file
canv|canvas|around
can|canvas|around
Icon|IconWeight|around
bright|brightblack|around
back|background|around
brigh|brightblack|around
brightb|brightblack|around
to|toHtml|around
Duto|Duotone|around
toH|toHtml|around
Duo|Duotone|around
Phosphor|Phosphor|around
Phos|Phosphor|buffer
s|src|file
pa|package|file
gi|github|around
PR|PROJECTS|around
Capa|Capability|around
hi|highlight|around
cte|cterm|around
Cur|CursorLine|around
da|dark|around
logo|logoColor|around